######
#    #
# ## #
# ## #
# ## #
# ## #
#$##.#
######
;
#########
#       #
# ##    #
# ##    #
# ##    #
# ##    #
#$##.   #
#########
;