#####
#@$.#
#####
;
 #######
##     #
#   .  #
#   $  #
# .$@$.#
####$  #
   #.  #
   #   #
   #####
;
######
#    #
# ## #
# ## #
# ## #
# ## #
#$##.#
######

